%%%%%%%%%%%%%%%%%%%%%%%%%%%%%%%%%%
%%%%%%%%%%%%%%%%%%%%%%%%%%%%%%%%%%
%%%%%%%%%%%%%%%%%%%%%%%%%%%%%%%%%%
%%%%%%%%%%%%%%%%%%%%%%%%%%%%%%%%%%
%%% % % % %. %    %..   %.   %o%%%
%%% %.%.%  1%% %% %%.%%      % %%%
%%% %  .% %.       .    %..  % %%%
%%%.  % . %  .    %%%% %%%%% % %%%
%%%   %%% %%%%%%% %..  . ..%   %%%
%%%   %.. .  ..% %%%%%%% %%%   %%%
%%% % %%%%% %%%%    .  % . %  .%%%
%%% %  ..%    .       .% %.  %%%%%
%%% %   3  %%.%% %% %%   %.%.%4%%%
%%%o%   .%   ..%    % .% % % %2%%%
%%%%%%%%%%%%%%%%%%%%%%%%%%%%%%%%%%
%%%%%%%%%%%%%%%%%%%%%%%%%%%%%%%%%%
%%%%%%%%%%%%%%%%%%%%%%%%%%%%%%%%%%
%%%%%%%%%%%%%%%%%%%%%%%%%%%%%%%%%%