%%%%%%%%%%%%%%%%%%%%%%%%%%%%%%%%%%
%   % 1 %.%. ..%    ...        %2%
% %.% % %.%% %%%  %     %. %% %%4%
% % %o%   %.   %  %%% %%% %%   % %
% % %3% % %. %    %..   %. % % % %
% % %.%.%   %% %% %%.%% %% % % % %
% % %  .% %.      %.    %..% % % %
% %.  % . %  .    %%%% %%%%% % % %
% % % %%%o%%%%%%% %..  . ..% % % %
% % % %.. .  ..% %%%%%%%o%%% % % %
% % % %%%%% %%%%    .  % . %  .% %
% % % %..%    .%      .% %.  % % %
% % % % %% %%.%% %% %%   %.%.% % %
% % % % .%   ..%    % .% % % % % %
% %   %% %%% %%%  %   .%   %o% % %
% %% %% .%     %  %%% %%.% % %.% %
% %        ...     .. .%.%   %   %
%%%%%%%%%%%%%%%%%%%%%%%%%%%%%%%%%%
