%%%%%%%%%%%%%%%%%%%%%%%%%%%%%%%%%%
%    1   . . ..     ...         2%
%  . 3   .               .      4%
%    o     .                     %
%          .       ..    .       %
% % %.%.%   %% %% %%.%% %% % % % %
%      .   .       .     ..      %
%  .    .    .                   %
% % % %%%o%%%%%%% %..  . ..% % % %
% % % %.. .  ..% %%%%%%%o%%% % % %
%                   .    .    .  %
%      ..     .       .   .      %
% % % % %% %%.%% %% %%   %.%.% % %
%       .    ..       .          %
%                     .     o    %
%       .               .     .  %
%          ...     .. . .        %
%%%%%%%%%%%%%%%%%%%%%%%%%%%%%%%%%%
